07
25
#######>########???####??
#.....m.m......#???#..#??
####..m*m......#####..###
@m....mmm....../........#
B...m.......$..#####....#
#..B...........#???#....#
################???######
10
